1111111111111
100000E000001
1000000000001
1P000000C0001
1111111111111